111111111111111
100000000002001
100000000222001
133000000200001
133300002202221
100000000000001
100000000000001
100000000011001
133300000011001
133300000011001
111111111111111
